[10 10]
XXXXXXXXXX
XH       X
X. .X..X.X
X. .X..X.X
X. .X..X.X
X. .X..X.X
X. .X..X.X
X. .X..X.X
X.R.X..XDO
XXXXXXXXXX
