[10 10]
XXXXXXXXXX
XH       X
X. .D..D.X
X. .D..D.X
X. .D..D.X
X. .D..D.X
X. .D..D.X
X. .D..D.X
X.R.X..XDO
XXXXXXXXXX