[15 15]
XXXXXXXXXXXXXXX
XH       M    X
X.  R .D.  .D.X
X.    .D.  .D.X
XF    .D.  .D.X
X.    .D.  .D.X
X.    .D.  .D.X
X.   M.D.  .D.X
X.    .D.  .D.X
X.    .D.  .D.X
X......D.  .D.X
X.D   .D....D.X
X.    .D.T .D.X
X.M....X.  .XDO
XXXXXXXXXXXXXXX