[15 15]
XXXXXXXXXXXXXXX
XH            X
X.    .D.  .D.X
X.    .D.  .D.X
XF    .D.  .D.X
X.    .D.  .D.X
X.    .D.  .D.X
X.    .D.  .D.X
X.    .D.  .D.X
X.    .D.  .D.X
X.RRRR.D.  .D.X
X.    .D.  .D.X
X.    .D.T .D.X
X.M....X.  .XDO
XXXXXXXXXXXXXXX